11111111111111111111111
111011111CCCCCCCCCCCCC1
111011111CCCCCCCCCCCCC1
111011111CCCCCCCCCCCCC1
111011111CCCCCCCCCCCCC1
111011111CCCCCCCCCCCCC1
111011111CCCCCCCCCCCCC1
111011111CCCCCCCCCCCCC1
111011111CCCCCCCCCCCCC1
111011111CCCCCCCCCCCCC1
111011111CCCCCCCCCCCCC1
111011111CCCCCCCCCCCCC1
111011111CCCCCCCCCCCCC1
111011111CCCCCCCCCCCCC1
111011111CCCCCCCCCCCCC1
111011111CCCCCCCCCCCCC1
111011111CCCCCCCCCCCCC1
111011111CCCCCCCCCCCCC1
111011111CCCCCCCCCCCCC1
111011111CCCCCCCCCCCCC1
111011111CCCCCCCCCCCCC1
111011111X0XCCCCCCCCCC1
1110000000EX00C00000P01
111011111XXXXXXXXXXXXX1
111011111XXXXXXXXXXXXX1
111011111XXXXXXXXXXXXX1
111011111XXXXXXXXXXXXX1
111011111XXXXXXXXXXXXX1
111011111XXXXXXXXXXXXX1
111011111XXXXXXXXXXXXX1
111011111XXXXXXXXXXXXX1
111011111XXXXXXXXXXXXX1
111C11111XXXXXXXXXXXXX1
111011111XXXXXXXXXXXXX1
111011111XXXXXXXXXXXXX1
111011111XXXXXXXXXXXXX1
111011111XXXXXXXXXXXXX1
111011111XXXXXXXXXXXXX1
111011111XXXXXXXXXXXXX1
111011111XXXXXXXXXXXXX1
111011111XXXXXXXXXXXXX1
111011111XXXXXXXXXXXXX1
111011111XXXXXXXXXXXXX1
111011111XXXXXXXXXXXXX1
11111111111111111111111
11111111111111111111111