111111111111111
1000000000CE001
1000000X0000P01
111111111111111