111111111111111111
100001111111111111
1P0001111111111111
1C0001111111111111
1E0001111111111111
10000XXX0000000001
111111111111111111