11111111111
1PC0XXXXXE1
10C00000001
11111111111