11111111111111111111111
1P000000CCCCC00000000E1
10000000CCXCC0000000001
11111111111111111111111