1111111111111111111111111111111111111111111111111111111111
11PC000000000111000000000001110000000000011100000000000001
1111111110000111000000000001110000000000011100000000000001
11111111E0100111111111111001111111111110011111111111110001
1111111001100111111111111001111111111110011111111111110001
1111110011100111111111111001111111111110011111111111000111
1111111111100111000000000001110000000000011111111111001111
1111111111100111000000000001110000000000011111111110001111
1111111111100111111111111001111111111110011111111000011111
1111111111100111111111111001111111111110011111111001111111
1111111111100111111111111001111111111110011111100011111111
1111111111100111000000000001110000000000011110000111111111
1111111111100111000000000001110000000000011110011111111111
1111111111100111111111111001111111111110011110011111111111
1111111111100000000000000000000000000000000000011111111111
1111111111111111111111111111111111111111111111111111111111