1111111111111111111111111111111111111111111111111111111111
11PC000000000111000000000001110000000000011100000000X00001
11111111100001110000000000011100000X0000011100000000000001
11111111E0100111111111111001111111111110011111111111110001
1111111001100111111111111001111111111110011111111111110001
1111110011100111111111111001111111111110011111111111000111
11111111111001110000X0000001110000000000011111111111001111
1111111111100111000000000001110000000000011111111110001111
1111111111100111111111111001111111111110011111111000011111
1111111111100111111111111001111111111110011111111001111111
1111111111100111111111111001111111111110011111100011111111
11111111111001110000000000011100000X0000011110000111111111
1111111111100111000000000001110000000000011110011111111111
1111111111100111111111111001111111111110011110011111111111
111111111110000000000000X000000000000000000000011111111111
1111111111111111111111111111111111111111111111111111111111