1111111111111111111111111111111111111111111111111111111111111111111111111111111111111111111111111
1111100000C00000000000000000000011111111111001110000000000000000000000000000000000000000011100001
11111P0000000000000000000000000011111111111001110000000000000000000000000000000000000000011100001
1111100000001111000000000000000011111111111001111111000000000000000000000000000000000000011100001
1111100000001111000000000000000011111111111001111111000000000000000000000000000000000000000000001
1000000000001111000111100000000000000000000000001111000000000000000000000000000000000000000000001
10000000000000000001111000000000000000000000000C0000000000000000000000000000000000000000000000001
1000000000000000000111100000000000000000000000000C00000C00000000000000000000000000000000000000001
1000000000000000000000000001111111111111111111000000000001110000000000000000001110000000011100001
1000000000000000000000000001111111111111111111000C00E00001110000000000000000001110000000011100001
1000000000000000000000000001111111111111111111000000000001110000000000000000001110000000011100001
1000000000000001111100000001111111111111111111000000000000000000000000000000000000000000000000001
1001111100C00001111100000001111111111111111111000000000000000000000000000000000000000000000000001
1001111100000001111100000000000111110000000000000000000000000000000000000000000001110000000000001
1001111100000000000000000000000111110000000000000000000000000000000000000000000001110000000000001
1000000000000000000000000000000000000000000000000000111000000000000000000000000001110000000000001
1000000000000000000000000000000000000000000000000000111000000000000000000000000000000000000000001
1000000000011111000000000000000000000000000000000000111000000000000000000000000000000000000000001
1111111111111111000111100000000000000000000000000000000000000000000000000000000000000000000000001
1111111111111111000111100000000000000000000000000000000000000000000000000000000000000000000000001
1111111111100000000111100000000000000000000000000111111000000000000000000000000000000000000000001
1111111111100000000000000000000000000000000000000111111000000000000000000000000000000000000000001
1111111111100000000000000000000000000000000000000111111000000000000000000000000000000000011100001
1111111100000000000000000000000000000000000000000000000000000000000000000000000000000000011100001
1111111100000000000000000000000000000000000000000000000000000000000000000000000000000000011100001
1111111111111111111111111111111111111111111111111111111111111111111111111111111111111111111111111