11111111111111111111111
1P000000CCCCC00000000E1
11111111111111111111111