11111111111111111111111
1P000000CCCCC00000000E1
1000000000X000000000001
11111111111111111111111