111111111111111111111111111111111111111111
1P000000000C0000000000000000000X0000000001
100000000000111111111111111111000000000001
100000000000111111111111111111000000000001
10000000000C0000000000000000000X0000000001
100000000000111111111111111111000000000001
100000000000111111111111111111000000000001
10000000000C0000000000000000000X0000000001
100000000000111111111111111111000000000001
100000000000111111111111111111000000000001
1000000000000000000000000000000X00000000E1
111111111111111111111111111111111111111111