111111111111111111111111111111111111
111000011111111111111111111111111111
111P00000000000001111111111111111111
11100001111110C001111111111111111111
111111111000000001111111000011111111
1111111110011111111111110C0000000011
111111111001111111111111000011110011
111111110000111111111111100111110011
111111110000111110000111100111110011
1111111100001111100C0000000111110011
111111110000000000000111111111110011
111111100001111111111111111111000011
111111100C0111111111111111111100E011
111111100001111111111111111111000011
111111111111111111111111111111111111