11111111111111111111111
1P000000CCCCC10000000E1
10000000111111000000001
10001111111111111100001
10001111111111111100001
10001111111111111100001
10001111111111111100001
10001111111111111100001
10001111111111111100001
10001111111111111100001
10001111111111111100001
10000000000000000000001
11111111111111111111111