1111111
1P0C0E1
100X001
1111111