1111111111111111111111111111
11111100X0000000111100011111
1111110000000000111100011111
1111111111111000111100011111
1111111111111000111100011111
1111111111111000111100011111
11111100000000X0000000011111
111111P000000C00000000E11111
1111110001111000111111111111
1111110001111000111111111111
1111110001111000111111111111
1111110001111000000000011111
1111110001111000X00000011111
1111111111111111111111111111