1111111111111111111111111111
1111110000000000111100011111
1111110000000000111100011111
1111111111111000111100011111
1111111111111000111100011111
1111111111111000111100011111
1111110000000000000000011111
111111P000000C00000000E11111
1111110001111000111111111111
1111110001111000111111111111
1111110001111000111111111111
1111110001111000000000011111
1111110001111000000000011111
1111111111111111111111111111